1111111111111
1C0E00C0000C1
1000011101001
1P00110000001
1101100C01111
1100E0C111111
1111111111111
