11111111111111111111
11111111100111111111
11111110111101111111
11111101111110111111
11111101111110111111
11111000000000011111
11111101111110111111
11111101111110111111
11111101111110111111
11111101111110111111
11111101111110111111
11111101111110111111
11111101111110111111
11111101111110111111
11111101111110111111
11111000111100011111
11001111100111110011
11011111100111111011
11011111100111111011
11101111011011110111
11110110111101101111
11111001111110011111
