1111111111111
1C0100C0000C1
1000011101001
1P00110000001
1111100C01111
1100E0C111111
1111111111111
